1111111111111111111111111111111111
1000000000000001P10000000000000001
10001C1000000000000000000000001111
1011110110000100000100000111100E01
1111111111111111111111111111111111