1111111111111111111111111111111111
1000000000000000000000000000000001
1001111110000010000010111111111001
1001000000000010000010000010000001
1001111110000011111110000010000001
1000000C100000100000100P0010000001
1001111110000010000010000010000E01
1000000000000000000000000000000001
1111111111111111111111111111111111