111111111111111111111111111111111111111111111111111111111111111111111111111111111111111111111111111111
10000P100000000000000000000000001110000000000000001000000000000011111000000000000000100000000000001111
10100101001000C010100100000001010110000000000000001000000000000011111000000000000000100000000000001111
10100101001000C010100100000001010110000000000000001000000000000011111000000000000000100000000000001111
10100101001000C010100100000001010110000000000000001000000000000011111000000000000000100000000000001111
10100101001000C010100100000001010110000000000000001000000000000011111000000000000000100000000000001111
1000000000000000C0000000000000111110000000000000001000000000000011111000000000000000100000000000001111
10100101001000C010100100000001010110000000000000001000000000000011111000000000000000100000000000001111
100000000000000010000000000000111110000000000000001000000000000011111000000000000000100000000000001111
111001001010101000100100000001010110000000000000001000000000000011111000000000000000100000000000001111
100000000000C0000000000000000000E110000000000000001000000000000011111000000000000000100000000000001111
111111111111111111111111111111111111111111111111111111111111111111111111111111111111111111111111111111